NO ./assets/N.xpm
SO ./assets/S1.xpm
WE ./assets/W1.xpm
EA ./assets/adam.xpm

F 0,0,225

C 225,0,0

      1111111111
      1000000N1
11111111001111111
1000000001
111111100111111111
      1000000001
      111111111
      1001
11111110011
10000000001
11111111111
