NO ./assets/N.xpm
SO ./assets/S1.xpm
WE ./assets/W1.xpm
EA ./assets/adam.xpm

F 0,0,225

C 225,0,0

1111111111111111111111111
1000000000110000000000001
1011000001110000000000001
1001000000000000000000001
1111111110110000011100001     1
100000000011000001110111111111011
11110111111111011100000010001 1
11110111111111011101010010001
11000000110101S11100000010001
10000000000000001100000010001
10000000000000001101010010001
1100000111010101111101111000111
11110111 1110101 101111010001
11111111 1111111 111111111111
