NO ./assets/N1.xpm
SO ./assets/S1.xpm
WE ./assets/W1.xpm
EA ./assets/E1.xpm

F 0,0,225

C 255,0,0

1111111111111111
1S000000000000001111
 111111100000000D001
        110100111111
        111111111
