NO ./assets/N.xpm
SO ./assets/S1.xpm
WE ./assets/W1.xpm
EA ./assets/adam.xpm

F 0,0,225

C 225,0,0

 1111111
1N00000M1
 1111111
